S00000010000000
1111101011111101
0000001000000101
0111111111110101
0100000000010001
0101111111011111
0101000001000001
0101011101111101
0001010001000101
1110010111010101
0000010100010001
0111110101111101
0100000101000101
0101111101010101
000100000001000E